....................WW
.................X..WW
..........##########WW
....................WW
WWW....WWWW.........WW
---....####.........WW
....................WW
WWW.................WW
###.........WWWWW...WW
............#####...WW
....WWW.............WW
....###.............WW
....................WW
.1........W.W.W.W.W.WW
######################
Pick up all the waterdrops and reach the exit in time.
