...........................
...........................
...........................
....W..T...T....T..........
..******........@@@@.......
...........................
....................T......
.............++++++++......
..............W....A*......
.W..S...W....@@@*****......
**********....W..........w.
.............@@@.......****
......W.......W............
X.1..***...W.***....T......
***.......***.......*****..
0,5
heard u liek ice
