........................
.......W........W.......
***.....................
......***......***......
1..........**..........X
****................****
........................
W.W.W..............W.W.W
*****..............*****
........................
W.W.W..............W.W.W
******............******
........................
...W.W............W.W...
...****..........****...
0,4
Slippery Sloopery Ice, Watch Out!
