..........................
..........................
r.........X...............
.......######.............
..W..............W.......R
####..W.W.W.W....###......
.......W.W.WBW...........W
......++++++++.........+++
....-...........-.........
..........................
W..W............W.W......W
####............####....##
.........................R
.1.........A.......W....A.
#######..*****************
0,4
Do not touch the flames, and watch how they move.
