.........................
r....................X...
.----..W............--..W
....W.--...............##
...--....-----...........
r.....................W.W
.......W....W.......#####
....W..######............
.........................
-----..........-----.....
.........................
W.W.............W.......R
---............-----.....
.1...W..W..W..W.W.W......
###..#..#..#..###########
0,5
You can throw Doritos with space or jump on the Sanics. KILL.
